C 255,30,0
NO ./m.cub
SO ./m.cub
WE ./m.cub

F 220,100,0
    
EA ./m.cub
    1111111111111111111111111
    1000000000110000000000001
    1011001001111110000100001
    1001000000001 10000000001
    1111111110111110011111111
11111110000000000000000000011
10000000000000000000000000001
10000000000000000000000000001
10000000000000000000000000001  1111111
1000000000000W000000000000001
10000000000000000000000000001
10000000100000001000000000001
11111111 1111101 111111111111
11111111 1111111 111111111111