C 255,30,0
NO ./m.cub
SO ./m.cub
WE ./m.cub

F 220,100,0
    
EA ./m.cub
    1111111111111111111111111
    1000000000110000000000001
    1011000001111110000000001
    1001000000001 10000000001
    1111111110111110011111111
111100000011000001110111111101111
11110111111111011100000010001
11110111111111011101010000001
11000000110101011100000010001  1111111
10000000000W00000000000010001
10000000000000001101010010001
110000011101010111110111100111
11110111 1110101 101111010001
11111111 1111111 111111111111
