C 255, 255, 255
NO ./test1.xpm
SO ./test2.xpm
WE ./test2.xpm

F 255, 255, 255
    
EA ./test2.xpm
    1111111111111111111111111
    1000000000110000000000001
    1011001001111110000100001
    1001000000001110000000001
    1111111110111110011111111
11111110000000000000000000011
10000000000000000000000000001
10000000000000000000000000001
10000000000000000000000000001  1111111
100000000000N0000000000000001
10000000000000000000000000001
10000000100000001000000000001
11111111 1111101 111111111111
11111111 1111111 111111111111