NO ./textures/minecraft.xpm
SO ./textures/minecraft.xpm
EA ./textures/minecraft.xpm
WE ./textures/minecraft.xpm

C 75, 0, 130
F 128, 128, 128 
    
1111111111 1111111 111111111111
1111111111111000111110111111111
1111110110010011111100001000011
1111110010000000011100000000011
1111111111111101111100111111111
1110000000000000000000000000111
1100000000001111111100000000011
11000000000011    1100000000011
11000000000011    1100000W00111
1100000000001111111100000000011
1100000000000000000000000000011
1100000011100000111000000000011
111111111 1111101 1111111111111
111111111 1111111 1111111111111
