NO ./texture/no_wall.xpm
SO ./texture/so_wall.xpm
EA ./texture/ea_wall.xpm
WE ./texture/we_wall.xpm

C 72, 61, 139
F 106, 113, 57
    
    111111111111111111111111111
    110000000001100000000000011
    110010000011111100000000011
    110010000000011100000000011
    111111111100111100111111111
1111111100000000000000000000111
1100000000000000000000000000011
1100000000000000000000000000001
1100000000000000N00000000000011
1100001000000011111000000000001
1100000000000000000000000100011
1100000011100000111000000000011
111111111 1111101 1111111111111
111111111 1111111 1111111111111
