NO ./texture/no_wall.xpm
SO ./texture/so_wall.xpm
WE ./texture/we_wall.xpm
EA ./texture/ea_wall.xpm

C 25, 25, 112
F 139, 69, 19
    
    1111111111111111111111111
    1000000000110000000000001
    1011001001111110000100001
    10010000001W1110000000001
    1111111110111110011111111
11111110000000000000000000011
10000000000000000000000000001
10000000000000000000000000001
10000000000000000000000000001
10000000000000000000000000001
10000000000000000000000000001
10000000100000001000000000001
11111111 1111101 111111111111
11111111 1111111 111111111111